0,0,0,0,0,0,0,
0,2,3,4,1,4,0,
0,1,2,0,2,3,0,
0,2,3,2,3,0,0,
0,3,2,0,4,6,0,
0,0,0,0,0,0,0,
0,0,0,0,0,0,0,