0,0,0,0,0,0,0,
4,3,1,0,3,4,0,
0,0,4,1,2,2,2,
3,4,2,1,4,3,0,
1,3,1,3,2,0,0,
4,0,2,2,1,3,6,
3,3,2,4,3,0,0,