0,0,0,0,0,0,0,
0,0,1,6,1,0,0,
0,1,4,2,1,4,0,
0,4,1,4,2,4,0,
0,4,2,2,4,1,0,
0,0,1,4,1,0,0,
0,0,0,0,0,0,0,