0,0,0,0,0,0,0,
0,0,0,0,0,0,0,
0,6,4,3,3,0,0,
0,0,0,2,4,3,0,
0,3,4,1,2,1,0,
0,0,0,0,3,4,0,
0,0,0,0,0,0,0,