0,0,0,0,0,0,0,
0,0,0,3,0,0,0,
0,6,0,4,0,3,0,
0,3,3,2,0,4,0,
0,4,1,4,3,2,0,
0,0,3,1,3,1,0,
0,4,3,2,1,4,0,