0,0,0,0,0,0,0,
0,6,2,4,1,4,0,
0,1,1,4,1,4,0,
0,4,1,1,2,2,0,
0,4,2,4,1,4,0,
0,1,2,4,1,4,0,
0,0,0,0,0,0,0,