0,0,0,0,0,0,0,
0,0,0,4,0,0,0,
0,3,1,2,1,3,0,
0,4,0,1,0,4,0,
0,1,2,6,2,1,0,
0,0,0,0,0,0,0,
0,0,0,0,0,0,0
