0,0,0,0,0,0,0,
0,0,4,1,4,0,0,
0,6,2,2,2,3,0,
0,4,2,1,2,1,0,
0,1,2,2,2,4,0,
0,0,3,4,3,0,0,
0,0,0,0,0,0,0,