0,0,0,0,0,0,0,
4,1,3,2,3,3,0,
1,0,2,4,1,4,0,
6,4,1,3,3,4,0,
1,1,1,2,0,1,0,
3,4,0,3,2,2,4,
0,0,0,0,4,3,0,